1111111111111
1001001000011
10111000100C1
10C1111100001
1P01E00001111
1111111111111
