111111111111111111111111111111111111111
100000100000000000000000000000000000001
10111000100C000000000000000000000000001
10C111110000100000000000000000000000001
1P01E0000111100000000000000000000000001
11111111111111111111111111111111111111
