1111111111111
1000001000011
10111000110C1
10C1111000001
1P00000E01111
1111111111111
