1111111111111
1000001000011
10111000110C1
10C1111110011
1P1E000000111
1111111111111
