1111111111111
1000001000111
10111000101C1
1001111100001
1P01E00001111
1111111111111
