11111111111111111
10000010000100001
10111000100C00001
10C11111000000001
1P01E000011100001
1000C000000000001
10000000000000001
100000000000C0001
11111111111111111
