111111111111
100000100001
101110001001
10C111110001
1001E00000P1
100000100001
100000100001
100000100001
100000100001
111111111111
