1111111111111
1000001000001
10111000100C1
10C1111100001
1P01E00001111
1111111111111

