111111111111111111111111111111111111111
10000010000000C000000000100000001C00001
101110001001100000010000010000000110001
10C111110000100010010000100000000000001
1001E000001P1C001C11000000001C000000001
111111111111111111111111111111111111111
